resentment - hatre
cosmopolitan - big city
fringe - edge
fable - fairy tale
tremulous - trembling
steep
turmoil - 
subsum - contain
shudder - 
discern - distinguish
expunge
rumble
subdue - 
cloack - 
bestow - bless
parry - block
infiltrate
blackened - smoke sth black
hideous - frighten
emanated - emit from inside
aura - halo
deftly - driftly
sanctuary - Jace's Sanctuary(MTG)
weary - tired
infidel - godless, heresy
falter - not confident with sth, shaking of faith
yearn - desire
scarcely - almost
scarce - lack
plight - delimma
forsake - abondon
prestige - authority